1111111111
1422222241
1333333331
1111221111
1333333331
1313131311
1222222221
1131313131
1332023331
1111111111