1111111111
1422223211
1212322211
1223222221
1221521221
1223232221
1222222221
1213333311
1222133241
1111111111