1111111111
1422222221
1222222221
1233322221
1232222221
1230333221
1222323331
1222322221
1232222241
1111111111