1111111111
1422212331
1333322221
1322233221
1221112221
1223032321
1221112221
1232233331
1322122241
1111111111