1111111111
1422223321
1113333331
1233322221
1322332321
1222330321
1111313331
1222222111
1333322241
1111111111