1111111111
1422222221
1331111331
1222332221
1233033221
1232333221
1223333221
1331111331
1222222241
1111111111