1111111111
1022222201
1111221111
1333333331
1111221111
1333333331
1111223331
1333333331
1222442221
1111111111