1111111111
1333333301
1211111111
1232223331
1222433221
1223342221
1333222321
1111111121
1033333331
1111111111