1111111111
1532332351
1332332331
1331221331
1331221331
1331331331
1331221331
1221331221
1421021241
1111111111