1111111111
1423222231
1223223231
1222322221
1222532221
1323223221
1322222321
1232223221
1111332241
1111111111