1111111111
1022222201
1222222221
1222222221
1333113331
1333113331
1112112111
1222222221
1422222241
1111111111