1111111111
1422222221
1222222221
1233322221
1222222221
1222022221
1222222221
1222233321
1222222241
1111111111